#########%##%####%%############%%####
# #       #       #     %         # #
# # ###%% # ### ##### ### ### ### # #
#       #   # #     #     # # #   # #
##### # ####% ##### %%# # # # ###%# #
#   # #       #     # # # # #     % #
# # ####### # # ##### #%# # ##%%# # #
# #       # # #   #     %     #   # #
% #%##### ### ### % ### ##%## # ##% #
#     %   # #   # #   #     # #     #
# ### ### # ### # #%### # # # #######
#   #   # # #   #   #   # # #   #   #
%###### # # # %#%## # ### # ### ### #
%     # #     #   # #   # #   #     #
% ### % ##### #%% # ### ### ####### #
# #   #     #     #   # # #       # #
# # ##### # ### ###%# # # ####### % #
# #     # # # # #     #       # #   #
# ###%# # # # ##% ##### ##### # #####
# #   # # #     #     # #   #       #
# # ### ### ### ##### %## # ####% # #
# #         #     #       #       # #
##%##########%#########%########%%###
